###################
#A  #             #
### # # ### # # # #
# #     # # # # # #
# # ### # # # # ###
#   #   # #   #   #
# ### ### # # # # #
#   # #       #   #
### # # # # # # # #
# # # # # #   # # #
# # # # # # ### # #
# #       #   #   #
# ### # # ### # # #
#     # #     # # #
# ### # ### # # # #
# #   #     # #   #
# ##### # ### # # #
#       #       #B#
###################