#################
#A    #         #
# ### # ##### # #
#     # #   #   #
# ####### # # ###
#         # #   #
# ### ##### ### #
#     #   #   # #
### # # # ### # #
# # # #     #   #
# # # # # ### # #
# # # # #   #   #
# # # # ### ### #
#         #     #
# # # ### #######
#     #        B#
#################