#####################
#A  #   #     #     #
# # # # # ### # ### #
# # # # # # #     # #
# # # # # # # ##### #
# #     # #     #   #
# ### # # ### # # ###
#                   #
# ##### # ### # # # #
#     # #   #     # #
### # ### # # ##### #
#   #         #     #
### # # ##### # ### #
#       #     # # # #
# ### # # # ### # # #
#     #         #  B#
#####################